###################################
#                                 #
#   #         #   #   #     # # #E#
#                                 #
# # ### ######    # # # ### # # # #
#                                 #
# # #   #           #   #         #
#                                 #
# # # ### ######### ##### ### ### #
#                                 #
# # # # #   #     #   #     # # # #
#                                 #
### # # ### # # ### #  # ### # ####
#                                 #
#S            #   # # # # #   #   #
#                                 #
###################################
